55555555555555555
50000000000000005
50005000000000005
51005000000009005
50005000000000005
50000000000000005
50000000000000005
50000000000000005
50000000000000005
55555555555555555
