55555555555555555
50000005000000005
50000000500050005
50500000050000555
50150005000005905
50500000000000505
50005000500050005
50000000050000055
50000000000000005
55555555555555555
