55555555555555555
51000000000000005
50000000000000005
50000000055500005
50000000050000005
50000000005055505
50000000005000505
50000000000550555
50000000000050095
55555555555555555
